0 0 0 0 0 0 39 35 35 35 35 35 35 35 35 35 35 35 35 35 35 35 40 0 0 0 0 0 0 0
0 0 0 0 0 0 36 46 46 46 46 46 46 46 46 46 46 46 46 46 46 46 37 0 0 0 0 0 0 0
0 0 0 0 0 0 36 45 45 45 45 45 45 45 45 45 45 45 45 45 45 45 37 0 0 0 0 0 0 0
0 0 0 0 0 0 36 48 48 48 48 48 48 48 48 48 48 48 48 48 48 48 37 0 0 0 0 0 0 0
0 0 0 0 0 0 36 2 2 2 2 2 2 2 2 2 2 2 2 2 2 2 37 0 0 0 0 0 0 0
0 0 0 0 0 0 36 1 1 1 1 1 1 1 1 1 1 1 1 1 1 1 37 0 0 0 0 0 0 0
0 0 0 0 0 0 36 1 1 1 1 1 1 1 1 1 1 1 1 1 1 1 37 0 0 0 0 0 0 0
0 0 0 0 0 0 36 1 1 1 1 1 1 1 1 1 1 1 1 1 1 1 37 0 0 0 0 0 0 0
0 0 0 0 0 0 36 1 1 1 1 1 1 1 1 1 1 1 1 1 1 1 37 0 0 0 0 0 0 0
0 0 0 0 0 0 36 1 1 1 1 1 1 1 1 1 1 1 1 1 1 1 37 0 0 0 0 0 0 0
0 0 0 0 0 0 36 1 1 1 1 1 1 1 1 1 1 1 1 1 1 1 37 0 0 0 0 0 0 0
0 0 0 0 0 0 36 1 1 1 1 1 1 1 1 1 1 1 1 1 1 1 37 0 0 0 0 0 0 0
0 0 0 0 0 0 36 1 1 1 1 1 1 1 1 1 1 1 1 1 1 1 37 0 0 0 0 0 0 0
0 0 0 0 0 0 36 1 1 1 1 1 1 1 1 1 1 1 1 1 1 1 37 0 0 0 0 0 0 0
0 0 0 0 0 0 33 38 38 38 38 38 40 1 1 1 1 1 39 38 38 38 34 0 0 0 0 0 0 0
0 0 0 0 0 0 0 0 0 0 0 0 36 1 1 1 1 1 37 0 0 0 0 0 0 0 0 0 0 0
0 0 0 0 0 0 0 0 0 0 0 0 36 1 1 1 1 1 37 0 0 0 0 0 0 0 0 0 0 0
0 0 0 0 0 0 0 0 0 0 0 0 36 1 1 1 1 1 37 0 0 0 0 0 0 0 0 0 0 0
0 0 0 0 0 0 0 0 0 0 0 0 36 1 1 1 1 1 37 0 0 0 0 0 0 0 0 0 0 0
0 0 0 0 0 0 0 0 0 0 0 0 36 1 1 1 1 1 37 0 0 0 0 0 0 0 0 0 0 0
35 35 35 35 35 35 35 35 35 35 35 35 34 1 1 1 1 1 37 0 0 0 0 0 0 0 0 0 0 0
46 63 46 46 46 46 46 46 46 46 46 46 46 1 1 1 1 1 37 0 0 0 0 0 0 0 0 0 0 0
45 45 45 45 45 45 45 45 45 45 45 45 45 1 1 1 1 1 37 0 0 0 0 0 0 0 0 0 0 0
48 48 48 48 48 48 48 48 48 48 48 48 48 1 1 1 1 1 37 0 0 0 0 0 0 0 0 0 0 0
2 2 2 2 2 2 2 2 2 2 2 2 2 1 1 1 1 1 37 0 0 0 0 0 0 0 0 0 0 0
1 1 1 1 1 1 1 1 1 1 1 1 1 1 1 1 1 1 37 0 0 0 0 0 0 0 0 0 0 0
1 1 1 1 1 1 1 1 1 1 1 1 1 1 1 1 1 1 37 0 0 0 0 0 0 0 0 0 0 0
1 1 1 1 1 1 1 1 1 1 1 1 1 1 1 1 1 1 37 0 0 0 0 0 0 0 0 0 0 0
1 1 1 1 1 1 1 1 1 1 1 1 1 1 1 1 1 1 37 0 0 0 0 0 0 0 0 0 0 0
38 38 38 38 38 38 38 38 38 38 38 38 38 38 38 38 38 38 34 0 0 0 0 0 0 0 0 0 0 0