35 34 34 34 34 34 34 34 34 34 34 34 34 34 34 34 34 34 34 36
37 40 40 40 40 40 40 40 40 40 40 40 40 40 40 40 40 40 40 37
37 39 39 39 39 39 39 39 39 39 39 39 39 39 39 39 39 39 39 37
37 44 44 44 44 44 44 44 44 44 44 44 44 44 44 44 44 44 44 37
37 0 0 0 0 0 0 0 0 0 0 0 0 0 0 0 0 0 0 37
37 0 0 0 0 0 0 0 0 0 0 0 0 0 0 0 0 0 0 37
37 0 0 0 0 0 0 0 0 0 0 0 0 0 0 0 0 0 0 37
37 0 0 0 0 0 0 0 0 0 0 0 0 0 0 0 0 0 0 37
37 0 0 0 0 0 0 0 0 0 0 0 0 0 0 0 0 0 0 37
37 0 0 0 0 0 0 0 0 0 0 0 0 0 0 0 0 0 0 37
37 0 0 0 0 0 0 0 0 0 0 0 0 0 0 0 0 0 0 37
37 0 0 0 0 0 0 0 0 0 0 0 0 0 0 0 0 0 0 37
37 0 0 0 0 0 0 0 0 0 0 0 0 0 0 0 0 0 0 37
37 0 0 0 0 0 0 0 0 0 0 0 0 0 0 0 0 0 0 37
37 0 0 0 0 0 0 0 0 0 0 0 0 0 0 0 0 0 0 37
37 0 0 0 0 0 0 0 0 0 0 0 0 0 0 0 0 0 0 37
37 0 0 0 0 0 0 0 0 0 0 0 0 0 0 0 0 0 0 37
37 0 0 0 0 0 0 0 0 0 0 0 0 0 0 0 0 0 0 37
37 0 0 0 0 0 0 0 0 0 0 0 0 0 0 0 0 0 0 37
32 34 34 34 34 34 34 34 34 34 34 34 34 34 34 34 34 34 34 33