0 0 0 0 0 0 0 0 0 0 0 0 0 0 0 0 0 0 0 0 0 0 0 0 0 0 0 0 0 0
0 0 0 0 0 0 0 0 0 0 0 0 0 0 0 0 0 0 0 0 0 0 0 0 0 0 0 0 0 0
0 0 0 0 0 0 0 0 0 0 0 0 0 0 0 0 0 0 0 0 0 0 0 0 0 0 0 0 0 0
0 0 0 0 0 0 0 0 0 0 0 0 0 0 0 0 0 0 0 0 0 0 0 0 0 0 0 0 0 0
0 0 0 0 0 0 0 0 0 0 0 0 0 0 0 0 0 0 0 0 0 0 0 0 0 0 0 0 0 0
0 0 0 0 0 0 0 0 0 0 0 0 0 0 0 0 0 0 0 0 0 0 0 0 0 0 0 0 0 0
0 0 0 0 0 0 0 0 0 0 0 0 0 0 0 0 0 0 0 0 0 0 0 0 0 0 0 0 0 0
0 0 0 0 0 0 0 0 0 0 0 0 0 0 0 0 0 0 0 0 0 0 0 0 0 0 0 0 0 0
0 0 0 0 0 0 0 0 0 0 0 0 0 0 0 0 0 0 0 0 0 0 0 0 0 0 0 0 0 0
0 0 0 0 0 0 0 0 39 35 35 35 35 35 35 35 35 35 35 40 0 0 0 0 0 0 0 0 0 0
0 0 0 0 0 0 0 0 36 43 43 43 43 43 43 43 43 43 43 37 0 0 0 0 0 0 0 0 0 0
0 0 0 0 0 0 0 0 36 42 42 42 42 42 42 42 42 42 42 37 0 0 0 0 0 0 0 0 0 0
0 0 0 0 0 0 0 0 36 47 47 47 47 47 47 47 47 47 47 37 0 0 0 0 0 0 0 0 0 0
0 0 0 0 0 0 0 0 36 2 2 2 2 2 2 2 4 2 2 37 0 0 0 0 0 0 0 0 0 0
0 0 0 0 0 0 0 0 36 1 1 1 1 1 1 1 1 1 1 37 0 0 0 0 0 0 0 0 0 0
0 0 0 0 0 0 0 0 36 1 1 1 1 1 1 1 1 1 1 37 0 0 0 0 0 0 0 0 0 0
0 0 0 0 0 0 0 0 36 1 1 1 1 1 1 1 1 1 1 37 0 0 0 0 0 0 0 0 0 0
0 0 0 0 0 0 0 0 36 1 1 1 3 1 1 1 1 1 1 37 0 0 0 0 0 0 0 0 0 0
0 0 0 0 0 0 0 0 36 1 1 1 1 1 1 1 1 1 1 37 0 0 0 0 0 0 0 0 0 0
0 0 0 0 0 0 0 0 36 1 1 1 1 1 1 1 1 3 1 37 0 0 0 0 0 0 0 0 0 0
0 0 0 0 0 0 0 0 33 38 38 38 38 1 1 38 38 38 38 34 0 0 0 0 0 0 0 0 0 0
0 0 0 0 0 0 0 0 0 0 0 0 0 0 0 0 0 0 0 0 0 0 0 0 0 0 0 0 0 0
0 0 0 0 0 0 0 0 0 0 0 0 0 0 0 0 0 0 0 0 0 0 0 0 0 0 0 0 0 0
0 0 0 0 0 0 0 0 0 0 0 0 0 0 0 0 0 0 0 0 0 0 0 0 0 0 0 0 0 0
0 0 0 0 0 0 0 0 0 0 0 0 0 0 0 0 0 0 0 0 0 0 0 0 0 0 0 0 0 0
0 0 0 0 0 0 0 0 0 0 0 0 0 0 0 0 0 0 0 0 0 0 0 0 0 0 0 0 0 0
0 0 0 0 0 0 0 0 0 0 0 0 0 0 0 0 0 0 0 0 0 0 0 0 0 0 0 0 0 0
0 0 0 0 0 0 0 0 0 0 0 0 0 0 0 0 0 0 0 0 0 0 0 0 0 0 0 0 0 0
0 0 0 0 0 0 0 0 0 0 0 0 0 0 0 0 0 0 0 0 0 0 0 0 0 0 0 0 0 0
0 0 0 0 0 0 0 0 0 0 0 0 0 0 0 0 0 0 0 0 0 0 0 0 0 0 0 0 0 0