0 0 0 0 0 0 0 0 0 0 0 0 0 0 0 0 0 0 0 0 0 0 0 0 0 0 0 0 0 0
0 0 0 0 0 0 0 0 0 0 0 0 0 0 0 0 0 0 0 0 0 0 0 0 0 0 0 0 0 0
0 0 0 0 0 0 0 0 0 0 0 0 0 0 0 0 0 0 0 0 0 0 0 0 0 0 0 0 0 0
0 0 0 0 0 0 0 0 0 0 0 0 0 0 0 0 0 0 0 0 0 0 0 0 0 0 0 0 0 0
0 0 0 0 0 0 0 0 0 0 0 0 0 0 0 0 0 0 0 0 0 0 0 0 0 0 0 0 0 0
0 0 0 0 0 0 0 0 0 0 0 0 0 0 0 0 0 0 0 0 0 0 0 0 0 0 0 0 0 0
0 0 0 0 0 0 0 0 0 0 0 0 0 0 0 0 0 0 0 0 0 0 0 0 0 0 0 0 0 0
0 0 0 0 0 0 0 0 0 0 0 0 0 0 0 0 0 0 0 0 0 0 0 0 0 0 0 0 0 0
0 0 0 0 0 0 0 0 0 0 0 0 0 0 0 0 0 0 0 0 0 0 0 0 0 0 0 0 0 0
0 0 0 0 0 39 35 35 35 35 35 35 35 35 35 35 35 35 35 35 35 35 35 35 40 0 0 0 0 0
0 0 0 0 0 36 54 54 54 54 54 54 54 54 54 54 54 54 54 54 54 54 54 54 37 0 0 0 0 0
0 0 0 0 0 36 53 53 53 53 53 53 53 53 53 53 53 53 53 53 53 53 53 53 37 0 0 0 0 0
0 0 0 0 0 36 52 52 52 52 52 52 52 52 52 52 52 52 52 52 52 52 52 52 37 0 0 0 0 0
0 0 0 0 0 36 50 50 50 50 50 50 50 50 50 50 50 50 50 50 50 50 50 50 37 0 0 0 0 0
0 0 0 0 0 36 49 49 49 49 49 49 49 49 49 49 49 49 49 49 49 49 49 49 37 0 0 0 0 0
0 0 0 0 0 36 49 49 49 49 49 49 49 49 49 49 49 49 49 49 49 49 49 49 37 0 0 0 0 0
0 0 0 0 0 36 49 49 49 49 49 49 49 49 49 49 49 49 49 49 49 49 49 49 37 0 0 0 0 0
0 0 0 0 0 36 49 49 49 49 49 49 49 49 49 49 49 49 49 49 49 49 49 49 37 0 0 0 0 0
0 0 0 0 0 36 49 49 49 49 49 49 49 49 49 49 49 49 49 49 49 49 49 49 37 0 0 0 0 0
0 0 0 0 0 36 49 49 49 49 49 49 49 49 49 49 49 49 49 49 49 49 49 49 37 0 0 0 0 0
0 0 0 0 0 36 49 49 49 49 49 49 49 49 49 49 49 49 49 49 49 49 49 49 37 0 0 0 0 0
0 0 0 0 0 33 38 38 38 38 38 38 38 38 38 38 38 38 38 38 38 38 38 38 34 0 0 0 0 0
0 0 0 0 0 0 0 0 0 0 0 0 0 0 0 0 0 0 0 0 0 0 0 0 0 0 0 0 0 0
0 0 0 0 0 0 0 0 0 0 0 0 0 0 0 0 0 0 0 0 0 0 0 0 0 0 0 0 0 0
0 0 0 0 0 0 0 0 0 0 0 0 0 0 0 0 0 0 0 0 0 0 0 0 0 0 0 0 0 0
0 0 0 0 0 0 0 0 0 0 0 0 0 0 0 0 0 0 0 0 0 0 0 0 0 0 0 0 0 0
0 0 0 0 0 0 0 0 0 0 0 0 0 0 0 0 0 0 0 0 0 0 0 0 0 0 0 0 0 0
0 0 0 0 0 0 0 0 0 0 0 0 0 0 0 0 0 0 0 0 0 0 0 0 0 0 0 0 0 0
0 0 0 0 0 0 0 0 0 0 0 0 0 0 0 0 0 0 0 0 0 0 0 0 0 0 0 0 0 0
0 0 0 0 0 0 0 0 0 0 0 0 0 0 0 0 0 0 0 0 0 0 0 0 0 0 0 0 0 0