0 0 0 0 0 0 0 0 0 0 0 0 0 0 0 0 0 0 0 0 0 0 0 0 0 0 0 0 0 0
0 0 0 0 0 0 0 0 0 0 0 0 0 0 0 0 0 0 0 0 0 0 0 0 0 0 0 0 0 0
0 0 0 0 0 0 0 0 0 0 0 0 0 0 0 0 0 0 0 0 0 0 0 0 0 0 0 0 0 0
0 0 0 0 0 0 0 0 0 0 0 0 0 0 0 0 0 0 0 0 0 0 0 0 0 0 0 0 0 0
0 0 0 0 0 0 0 0 0 0 0 0 0 0 0 0 0 0 0 0 0 0 0 0 0 0 0 0 0 0
0 0 0 0 0 0 0 0 0 0 0 0 0 0 0 0 0 0 0 0 0 0 0 0 0 0 0 0 0 0
0 0 0 0 0 0 0 0 0 0 0 0 0 0 0 0 0 0 0 0 0 0 0 0 0 0 0 0 0 0
0 0 0 0 0 0 0 0 0 0 0 0 0 0 0 0 0 0 0 0 0 0 0 0 0 0 0 0 0 0
0 0 0 0 0 0 0 0 0 0 0 0 0 0 0 0 0 0 0 0 0 0 0 0 0 0 0 0 0 0
0 0 0 0 0 39 35 35 35 35 35 35 35 35 35 35 35 35 35 35 35 35 35 35 40 0 0 0 0 0
0 0 0 0 0 36 43 43 43 43 43 43 43 43 43 43 43 43 43 43 43 43 43 43 37 0 0 0 0 0
0 0 0 0 0 36 42 42 42 42 42 42 42 42 42 42 42 42 42 42 42 42 42 42 37 0 0 0 0 0
0 0 0 0 0 36 47 47 47 47 47 47 47 47 47 47 47 47 47 47 47 47 47 47 37 0 0 0 0 0
0 0 0 0 0 36 14 14 14 14 14 14 14 14 14 14 14 14 14 14 14 14 14 14 37 0 0 0 0 0
0 0 0 0 0 36 13 13 13 13 13 13 13 13 13 13 13 13 13 13 13 13 13 13 37 0 0 0 0 0
0 0 0 0 0 36 13 13 13 13 13 13 13 13 13 13 13 13 13 13 13 13 13 13 37 0 0 0 0 0
0 0 0 0 0 36 13 13 13 13 13 13 13 13 13 13 13 13 13 13 13 13 13 13 37 0 0 0 0 0
0 0 0 0 0 36 13 13 13 13 13 13 13 13 13 13 13 13 13 13 13 13 13 13 37 0 0 0 0 0
0 0 0 0 0 36 13 13 13 13 13 13 13 13 13 13 13 13 13 13 13 13 13 13 37 0 0 0 0 0
0 0 0 0 0 36 13 13 13 13 13 13 13 13 13 13 13 13 13 13 13 13 13 13 37 0 0 0 0 0
0 0 0 0 0 36 13 13 13 13 13 13 13 13 13 13 13 13 13 13 13 13 13 13 37 0 0 0 0 0
0 0 0 0 0 33 38 38 38 38 38 38 38 38 38 38 38 38 38 38 38 38 38 38 34 0 0 0 0 0
0 0 0 0 0 0 0 0 0 0 0 0 0 0 0 0 0 0 0 0 0 0 0 0 0 0 0 0 0 0
0 0 0 0 0 0 0 0 0 0 0 0 0 0 0 0 0 0 0 0 0 0 0 0 0 0 0 0 0 0
0 0 0 0 0 0 0 0 0 0 0 0 0 0 0 0 0 0 0 0 0 0 0 0 0 0 0 0 0 0
0 0 0 0 0 0 0 0 0 0 0 0 0 0 0 0 0 0 0 0 0 0 0 0 0 0 0 0 0 0
0 0 0 0 0 0 0 0 0 0 0 0 0 0 0 0 0 0 0 0 0 0 0 0 0 0 0 0 0 0
0 0 0 0 0 0 0 0 0 0 0 0 0 0 0 0 0 0 0 0 0 0 0 0 0 0 0 0 0 0
0 0 0 0 0 0 0 0 0 0 0 0 0 0 0 0 0 0 0 0 0 0 0 0 0 0 0 0 0 0
0 0 0 0 0 0 0 0 0 0 0 0 0 0 0 0 0 0 0 0 0 0 0 0 0 0 0 0 0 0